30 23
100 100

4 5 4 5 4 5 4 5 4 5 4 5 4 5 4 5 4 5 4 5 4 5 4 5 4 5 4 5 4 5
3 0 0 1 0 2 0 0 0 0 0 0 0 0 2 0 0 2 0 0 0 1 2 0 0 0 0 0 2 3
3 0 0 0 2 0 1 0 0 0 0 0 2 0 0 2 0 0 0 0 1 0 0 2 0 0 2 0 1 3
3 6 6 6 6 6 6 6 6 6 6 6 6 6 6 6 6 6 6 6 6 6 6 6 6 6 6 1 0 3
3 0 0 0 0 2 1 0 0 0 0 2 0 0 1 0 0 2 0 0 0 1 0 0 0 0 2 0 2 3

3 0 0 0 2 0 1 0 0 0 0 0 2 0 0 2 0 0 0 0 1 0 0 2 0 0 2 0 1 3
3 0 1 6 6 6 6 6 6 6 6 6 6 6 6 6 6 6 6 6 6 6 6 6 6 6 6 6 9 3
3 1 0 0 1 0 0 0 0 0 0 0 0 0 0 0 0 0 1 2 0 0 0 0 2 1 2 0 0 3
3 0 0 0 2 2 2 0 1 0 0 0 0 0 0 0 0 0 1 0 1 0 0 0 0 0 2 2 1 3
3 6 9 6 6 6 6 6 6 6 6 6 6 6 6 6 6 6 6 6 6 6 6 6 6 6 6 1 0 3

3 8 8 8 8 8 8 8 8 8 8 8 8 8 8 8 8 8 8 8 8 8 8 8 10 7 7 7 7 3
3 8 8 8 8 8 8 8 8 8 8 8 8 8 8 8 8 8 8 8 8 8 8 8 10 7 7 7 7 3
3 8 8 9 9 9 9 9 9 9 9 9 9 9 9 9 9 9 9 9 9 9 9 9 9 9 9 9 9 9
3 8 8 8 8 8 8 8 8 8 8 8 8 8 8 8 8 8 8 8 8 8 8 8 8 8 8 8 8 3
3 8 8 8 8 8 8 8 8 8 8 8 8 8 8 8 8 8 8 8 8 8 8 8 8 8 8 8 8 3
3 8 8 9 9 9 9 9 9 9 9 9 9 9 9 9 9 9 9 9 9 9 9 9 9 7 7 7 7 3
3 7 7 7 7 7 7 7 7 7 7 7 7 7 7 7 7 7 7 7 7 7 7 7 10 7 7 7 7 3
3 7 7 7 7 7 7 7 7 7 7 7 7 7 7 7 7 7 7 7 7 7 7 7 10 7 7 7 7 3
3 13 13 6 6 6 6 6 6 6 6 6 6 6 6 6 6 6 6 6 6 6 6 6 6 6 6 6 3
3 12 12 12 12 12 12 12 12 12 12 12 12 12 12 12 12 12 12 12 3
3 12 12 12 12 12 12 12 12 12 12 12 12 12 12 12 12 12 12 12 3
3 12 12 12 12 12 12 12 12 12 12 12 12 12 12 12 12 12 12 12 3
4 5 4 5 4 5 4 5 4 5 4 5 4 5 4 5 4 5 4 5 4 5 4 5 4 5 4 5 4 5