32 23
100 100

4 5 4 5 4 5 4 5 4 5 4 5 4 5 4 5 4 5 4 5 8 8 8 8 8 8 8 8 8 8 8 4
3 0 0 0 2 0 0 2 0 0 0 1 2 0 0 0 0 0 2 3 8 8 8 8 8 8 8 8 7 7 7 3
3 0 2 0 0 2 1 0 0 0 13 0 0 2 0 0 2 0 1 3 8 8 8 8 8 8 8 8 7 9 7 3 
3 6 6 6 6 6 6 6 6 6 6 6 6 6 6 6 6 1 0 3 8 8 8 8 8 8 8 8 7 9 7 3
3 0 0 0 1 0 0 2 0 0 0 1 0 0 0 0 2 0 2 3 8 8 8 8 8 8 8 8 7 9 7 3

3 0 2 0 13 2 0 0 0 0 13 0 0 2 0 0 2 0 1 3 8 8 8 8 8 8 8 8 7 9 7 3
3 0 6 6 6 6 6 6 6 6 6 6 6 6 6 6 6 6 6 3 8 8 8 8 8 8 8 8 7 9 7 3
3 1 0 0 0 0 0 1 2 0 0 0 0 2 1 2 0 0 2 3 8 8 8 8 8 8 8 8 7 9 7 3
3 0 0 0 13 0 0 0 1 0 1 0 0 0 13 0 2 2 1 3 8 8 8 8 8 8 8 8 7 9 7 3  
3 6 6 6 6 6 6 6 6 6 6 6 6 6 6 6 6 1 0 3 8 8 8 8 8 8 8 8 7 9 7 3

3 8 8 8 8 8 8 8 8 8 8 8 8 8 10 7 7 7 7 3 9 9 9 9 9 9 9 10 7 9 7 3
3 8 8 8 8 8 8 8 8 8 8 8 8 8 10 7 7 7 7 3 14 14 0 1 13 2 0 10 7 9 7 3
3 8 9 9 9 9 9 9 9 9 9 9 9 9 9 9 9 9 9 3 14 14 13 0 0 0 13 2 7 9 7 3
3 8 8 8 8 8 8 8 8 8 8 8 8 8 8 8 8 8 8 3 9 9 9 9 9 9 9 9 9 9 7 3
3 8 8 8 8 8 8 8 8 8 8 8 8 8 8 8 8 8 8 3 8 8 8 8 8 8 8 8 8 9 7 3
3 9 9 9 9 9 9 9 9 9 9 9 9 9 9 10 10 10 10 3 8 8 8 8 8 8 8 8 8 9 7 3    
3 7 7 7 7 7 7 7 7 7 7 7 7 7 7 7 7 7 7 3 8 8 8 8 8 8 8 8 8 9 7 3
3 7 7 7 7 7 7 7 7 7 7 7 7 7 7 7 7 7 7 3 8 8 8 8 8 8 8 8 8 9 7 3
3 12 12 6 6 6 6 6 6 6 6 6 6 6 6 6 6 6 6 3 8 8 8 8 8 8 8 8 8 9 7 3  
3 12 12 11 11 11 11 11 11 11 11 11 11 11 11 11 11 11 11 11 11 11 11 11 11 11 11 11 11 11 11 3
3 11 11 11 11 11 11 11 11 11 11 11 11 11 11 11 11 11 11 11 11 11 11 11 11 11 11 11 11 11 11 3
3 11 11 11 11 11 11 11 11 11 11 11 11 11 11 11 11 11 11 11 11 11 11 11 11 11 11 11 11 11 11 3
4 5 4 5 4 5 4 5 4 5 4 5 4 5 4 5 4 5 4 5 8 8 8 8 8 8 8 8 8 8 8 4